adequate	a.	足够的；适当的
ambitious	a.	雄心勃勃的；有野心的
attain	v.	达到；获得
barrier	n.	障碍；栅栏
beckon	v.	招手；引诱
bland	a.	平淡无味的；温和的
coincide	v.	巧合；同时发生
comply	v.	遵从；服从
concentrate	v.	集中；浓缩
confess	v.	坦白；承认
conflict	n.	冲突；争议
confront	v.	面对；对抗
conserve	v.	保存；节约
depress	v.	使沮丧；压制
distract	v.	分散注意力；转移
domestic	a.	国内的；家庭的
dual	a.	双的；二重的
elevate	v.	提升；举起
epidemic	a.	传染的；流行的
eternal	a.	永恒的；不朽的
exceed	v.	超过；胜过
exert	v.	运用；施加
fade	v.	褪色；消失
fascinate	v.	吸引；迷住
feasible	a.	可行的；可实行的
frown	v.	皱眉；不悦
frustrate	v.	挫败；使灰心
guarantee	v.	保证；担保
haunt	v.	萦绕不去；鬼魂出没
hereditary	a.	遗传的；世袭的
